 | |4| | |2| | |8
 |3| | |7| | |1|
1| | |6| | |7| |
2| | |1| | |9| |
 |5| | |2| | |4|
 | |6| | |3| | |2
 | |1| | |6| | |3
 |8| | |9| | |6|
7| | |2| | |4| |
-
6|7|4|9|1|2|3|5|8
8|3|9|4|7|5|2|1|6
1|2|5|6|3|8|7|9|4
2|4|8|1|6|7|9|3|5
3|5|7|8|2|9|6|4|1
9|1|6|5|4|3|8|7|2
4|9|1|7|8|6|5|2|3
5|8|2|3|9|4|1|6|7
7|6|3|2|5|1|4|8|9
